.................@....@@@.....
@@@..@@@@@.....@@@..@@@@@.....
..@....@@@....................
.......@.........@....@@@.....
..............................
@@@@@@@@.......@@@..@@@@@.....
..@..............@....@@@.....
....@@@@......................
....@.......@@@...............
........@.....................
........@......@@@..@@@@@.....
............@@...@....@@@.....
........@.....................
....@...@.....................
........@......@@@..@@@@@.....
.................@....@@@.....
@@@..@@@@@.......@....@@@.....
..@....@@@.....@@@..@@@@@.....
.......@.........@....@@@.....
...............@@@..@@@@@.....
@@@@@@@@......................
..@...........................
....@@@@.........@............
....@.......@@@..@............
........@......@@@..@@@@@.....
........@........@............
............@@.@@@..@@@@@.....
........@.....................
....@...@........@....@@@.....
........@........@....@@@.....