....................
@.@.@.@....@...@@@..
..@.......@....@..@.
@.@.@.@@.@@@@.......
....................
........@...........
@.@.@.@....@...@@@..
@.@.@.@....@...@@@..
@.@.@.@@.@@@@.......
@.@.@.@@.@@@@.......
....................
....................
@@@.................
@.@.@.@.@.....@@....
.................@.@
....................
....................
@.@.@.@....@...@@@..
@.@.@.@....@...@@@..
....................