...............
@@@..@@@@@.....
..@....@@@.....
.......@.......
...............
@@@@@@@@.......
..@............
....@@@@.......
....@.......@@@
........@......
........@......
............@@
........@......
....@...@......
........@......