..........
@@@.......
..@....@@@
.......@..
.......@..
@@@@@.....
..........
....@@@@..
....@.....
..........