..................................................
@@@..@@@@@........................................
..@....@@@........................................
.......@..........................................
..................................................
@@@@@@@@..........................................
..@.........................@@@@@@@@@@@@@@@@@@@@@@
....@@@@..........................................
....@.......@@@...................................
........@.........................................
........@.........................................
............@@....@@@@@@@@@@@@@...................
........@.........................................
....@...@.........................................
........@.........................................
........@.................@@@@@@@@@@@@@...........
........@.........................................
........@.........................................
........@.........................................
........@.........................................
........@.........................................
........@....................@@@@@@@@@@@@@@@@@@@@@
...@@...@.........................................
........@.........................................
........@.........................................
........@................@@@@@....................
........@............................@@@@@........
........@.........................................
........@.........................................
........@.........................................
........@.........................................
........@.........................................
........@...............@@@@@@@@@@@@@@@@@@@@@.....
........@.........................................
........@.........................................
........@.........................................
........@.........................................
........@...............@@@.......................
........@.........................................
........@.........................................
........@.........................................
.............................................@@@@@
........@@@@@@@@@@@@@@@@@@@@@@@@@@@@..............
........@.........................................
........@.........................................
........@.......................................@@
........@.........................................
........@..............................@@@@@@.....
........@.........................................
........@.........................................