..............................................................@@....@@@@@@@@@@@@@...................
@@@..@@@@@..........................................@....@@@........................................
..@....@@@..........................................@....@@@........................................
.......@............................................@....@@@........................................
..............................................................@@....@@@@@@@@@@@@@...................
@@@@@@@@............................................................................................
..@.........................@@@@@@@@@@@@@@@@@@@@@@..@....@@@........................................
....@@@@............................................@....@@@........................................
....@.......@@@.....................................@....@@@........................................
........@.....................................................@@....@@@@@@@@@@@@@...................
........@...........................................@....@@@........................................
............@@....@@@@@@@@@@@@@...........................@............................@@@@@........
........@.................................................@............................@@@@@........
....@...@...........................................@....@@@........................................
........@.....................................................@@....@@@@@@@@@@@@@...................
........@.................@@@@@@@@@@@@@.............@....@@@........................................
........@...........................................@....@@@........................................
........@...........................................................................................
........@.....................................................@@....@@@@@@@@@@@@@...................
........@...........................................@....@@@........................................
........@.................................................@............................@@@@@........
........@....................@@@@@@@@@@@@@@@@@@@@@........@............................@@@@@........
...@@...@.................................................@............................@@@@@........
........@.................................................@............................@@@@@........
........@...........................................................................................
........@................@@@@@............................@............................@@@@@........
........@............................@@@@@..........................................................
........@...........................................................................................
........@...........................................@....@@@........................................
........@.....................................................@@....@@@@@@@@@@@@@...................
........@...........................................................................................
........@...........................................@....@@@........................................
........@...............@@@@@@@@@@@@@@@@@@@@@.......@....@@@........................................
........@...........................................................................................
........@.................................................@............................@@@@@........
........@.................................................@............................@@@@@........
........@...........................................................................................
........@...............@@@.........................................................................
........@.................................................@............................@@@@@........
........@.................................................@............................@@@@@........
........@...........................................................................................
.............................................@@@@@..@....@@@........................................
........@@@@@@@@@@@@@@@@@@@@@@@@@@@@..........................@@....@@@@@@@@@@@@@...................
........@...........................................................................................
........@...........................................................................................
........@.......................................@@........@............................@@@@@........
........@.................................................@............................@@@@@........
........@..............................@@@@@@.............@............................@@@@@........
........@...........................................................................................
........@.....................................................@@....@@@@@@@@@@@@@...................
....................................................@....@@@........................................
@@@..@@@@@..........................................@....@@@........................................
..@....@@@................................................@............................@@@@@........
.......@............................................................................................
....................................................................................................
@@@@@@@@............................................................................................
..@.........................@@@@@@@@@@@@@@@@@@@@@@..................................................
....@@@@......................................................@@....@@@@@@@@@@@@@...................
....@.......@@@.....................................................................................
........@...........................................@....@@@........................................
........@...........................................@....@@@.............@@@@@@@@@@@@@@@@@@@@@@@@@@@
............@@....@@@@@@@@@@@@@.....................................................................
........@.................................................@............................@@@@@........
....@...@.................................................@............................@@@@@........
........@.................................................@............................@@@@@........
........@.................@@@@@@@@@@@@@...................@............................@@@@@........
........@...........................................................................................
........@...........................................@....@@@........................................
........@...........................................@....@@@........................................
........@.....................................................@@....@@@@@@@@@@@@@...................
........@...........................................@....@@@........................................
........@....................@@@@@@@@@@@@@@@@@@@@@..................................................
...@@...@...........................................@....@@@........................................
........@.................................................@............................@@@@@........
........@.....................................................@@....@@@@@@@@@@@@@...................
........@................@@@@@................................@@....@@@@@@@@@@@@@...................
........@............................@@@@@....................@@....@@@@@@@@@@@@@...................
........@.....................................................@@....@@@@@@@@@@@@@...................
........@.................................................@............................@@@@@........
........@.................................................@............................@@@@@........
........@.................................................@............................@@@@@........
........@...........................................................................................
........@...............@@@@@@@@@@@@@@@@@@@@@.......................................................
........@...........................................@....@@@........................................
........@...........................................@....@@@........................................
........@...........................................................................................
........@...........................................@....@@@........................................
........@...............@@@.........................................................................
........@.....................................................@@....@@@@@@@@@@@@@...................
........@...........................................................................................
........@...........................................................................................
.............................................@@@@@..................................................
........@@@@@@@@@@@@@@@@@@@@@@@@@@@@................................................................
........@...........................................@....@@@........................................
........@...........................................................................................
........@.......................................@@............@@....@@@@@@@@@@@@@...................
........@...........................................@....@@@........................................
........@..............................@@@@@@.......@....@@@........................................
........@...........................................................................................
........@...........................................................................................